2.0 EHCI=2.0 (EHCI)
3.0 nec XHCI=3.0 (nec XHCI)
3.0 qemu XHCI=3.0 (qemu XHCI)
Allocation=Répartition
and if using graphics device passthrough it too needs UEFI=L'utilisation d'une carte graphique dédiée nécessite le mode UEFI
Are you sure=Êtes-vous certain
Array must be started to view Virtual Machines=L'Array doit être démarré pour voir les Machines Virtuelles
Autostart=Auto-Démarrage
Back=Retour
Bus=Bus
Capacity=Capacité
Change Icon=Changer l'icône
Cleanup=Nettoyer
Click and Select cdrom image to install operating system=Cliquer et sélectionner une image de cdrom pour installer un système d'exploitaton
Config Folder=Dossier de config
Copy Paste Domain XML Configuration Here=Copier-Coller la configuration XML de domaine Ici
CPU Mode=Mode de CPU
CPUs=CPUs
Create=Créer
Creating=Création en cours
define the amount memory=spécifier la quantité de mémoire
define the maximum amount of memory=spécifier la quantité maximale de mémoire
define type of cpu presented to this vm=spécifier le type de cpu alloué à cette VM
description of virtual machine=description de la Machine Virtuelle
Disk devices=Disques
Download Folder=Dossier de téléchargement
Download, Click and Select virtio drivers image=Télécharger, cliquer et sélectionner l'image des pilotes VirtIO
Downloading=Téléchargement en cours
eg=par ex.
Emulated=Émulé
Extracting=Extraction en cours
Folder to save the LibreELEC image to=Dossier pour sauvegarder l'image LibreELEC
Folder to save the OpenELEC image to=Dossier pour sauvegarder l'image OpenELEC
Form View=Vue Formulaire
free=libre
Graphics Card=Carte graphique
Graphics ROM BIOS=ROM BIOS de carte graphique
Graphics=Mode graphique
Host Passthrough=Accès Direct
Hyperv tweaks for Windows=Ajustements HyperV pour Windows
Hyper-V=Hyper-V
i440fx will work for most=i440fx fonctionnera pour la plupart
Icon=Icône
Initial=Initial(e)
Invalid VM to edit=Impossible d'éditer cette VM
ISO storage path doesnt exist=Le chemin d'accès des fichiers ISO est inexistant
ISO storage path was empty=Le chemin d'accès des fichiers ISO est vide
keyboard for VNC=clavier pour VNC
LibreELEC Version=Version de LibreELEC
LibreELEC=LibreELEC
Libvirt Service failed to start=Le démarrage du service Libvirt a échoué
Logical CPUs=CPUs logiques
Machine=Machine
Manual=Manuel
Max=Max
MD5 verification failed, your download is incomplete or corrupted=Échec de la vérification MD5, votre téléchargement est incomplet ou corrompu
mount tag inside vm=Point de montage à l'intérieur de la VM
My Workstation=Mon Poste de Travail
name of mount tag inside vm=Nom du point de montage à l'intérieur de la VM
Name of virtual machine=Nom de la Machine Virtuelle
Network Bridge=Pont Réseau
Network MAC=Adresse Réseau MAC
Network Model=Modèle Réseau
No Virtual Machines installed=Aucune Machine Virtuelle installée
None available=Aucun(e) n'est disponible
Not enough free space, need at least=Espace insuffisant, besoin d'au moins
Not running=À l'arrêt
OpenELEC Version=Version OpenELEC
OpenELEC=OpenELEC
OS Install CDRom Bus=BUS CDRom du Système d'exploitation
OS Install ISO=ISO du Système d'exploitation
Other PCI Devices=Autres Périphériques PCI
OVMF requires a UEFI-compatable OS=OVMF requiert un Système d'exploitation compatible UEFI
OVMF=OVMF
password for VNC=mot de passe pour VNC
path of Unraid share=chemin du partage Unraid
path on Unraid share to save LibreELEC settings=chemin du partage Unraid pour sauvegarder les paramètres LibreELEC
path on Unraid share to save OpenELEC settings=chemin du partage Unraid pour sauvegarder les paramètres OpenELEC
Path to ROM BIOS file=chemin des fichiers ROM BIOS
Please choose a folder the LibreELEC image will download to=Sélectionner un dossier où télécharger l'image LibreELEC
Please choose a folder the OpenELEC image will download to=Sélectionner un dossier où télécharger l'image OpenELEC
Primary=Principal
Q35 for a newer machine model with PCIE=Q35 pour un modèle de machine récent avec PCIE
QEMU64=QEMU64
random mac, you can supply your own=adresse MAC aléatoire, vous pouvez entrer la vôtre
re-generate random mac address=regénérer l'adresse MAC aléatoire
Remove LibreELEC image=Supprimer l'image LibreELEC
Remove OpenELEC image=Supprimer l'image OpenELEC
Remove this LibreELEC file=Supprimer ce fichier LibreELEC
Remove this OpenELEC file=Supprimer ce fichier OpenELEC
SeaBIOS will work for most=SeaBIOS fonctionne pour la plupart
SeaBIOS=SeaBIOS
Select the BIOS=Sélectionner un BIOS
Select the LibreELEC version to use=Sélectionner une version de LibreELEC à utiliser
Select the machine model=Sélectionner le modèle de Machine
Select the OpenELEC version to use=Sélectionner une version de OpenELEC à utiliser
Select the USB Controller to emulate=Sélectionner le type de controlleur USB à émuler
Separate sub-folder and image will be created based on Name=Un sous-dossier et une image seront créés en fonction du nom
shares=Dossiers Partagés
Some OSes wont support USB3=Certains Systèmes d'exploitation ne supportent pas USB3
Sound Card=Carte Son
Start All=Tout Démarrer
Start VM after creation=Démarrer la VM après sa création
Stop All=Tout Arrêter
Toggle VM autostart=Basculer l'auto-démarrage de la VM
type of storage image=Type de stockage de l'image
Unknown action=Action inconnue
Unknown version=Version inconnue
Unraid Mount tag=Balise de point de montage Unraid
Unraid Share=Partage Unraid
Updating=Mise à jour
USB Controller=Contrôleur USB
USB Devices=Périphériques USB
vDisk Bus=Bus vDisk
vDisk Location=Emplacement du vDisk
vDisk Size=Taille du vDisk
vDisk Type=Type du vDisk
vDisks=vDisks
video for VNC=vidéo pour VNC
VirtIO Drivers CDRom Bus=Bus CDROm des pilotes VirtIO
VirtIO Drivers ISO=ISO des Pilotes VirtIO
Virtual Machines=Machines Virtuelles
VM creation error=erreur de création de VM
VM image deletion error=erreur de suppression d'image de VM
VNC Keyboard=Clavier VNC
VNC Password=Mot de passe VNC
VNC Video Driver=Pilote Vidéo VNC
VNC=VNC
Wasnt able to stop the process=Incapable d'arrêter le processus
Windows 7XP=Windows 7/XP
Windows 82012, newer Linux distros=Windows 8/2012, nouvelles distros Linux
XML View=Vue XML

; New entries - 2021-03-14
20 EHCI=2.0 (EHCI)
30 nec XHCI=3.0 (nec XHCI)
30 qemu XHCI=3.0 (qemu XHCI)
